//MAP CONVERTED BY dmm2tgm.py THIS HEADER COMMENT PREVENTS RECONVERSION, DO NOT REMOVE
"a" = (
/obj/machinery/sleeper/clockwork,
/turf/open/floor/clockwork/reebe,
/area/reebe/city_of_cogs)
"b" = (
/turf/open/indestructible/reebe_void,
/area/reebe)
"c" = (
/obj/machinery/door/airlock/clockwork/glass{
	name = "Infirmary"
	},
/turf/open/floor/clockwork/reebe,
/area/reebe/city_of_cogs)
"d" = (
/obj/structure/chair/brass{
	dir = 1
	},
/turf/open/floor/clockwork/reebe,
/area/reebe/city_of_cogs)
"e" = (
/obj/structure/table/brass,
/turf/open/floor/clockwork/reebe,
/area/reebe/city_of_cogs)
"g" = (
/obj/machinery/computer/camera_advanced/ratvar{
	dir = 4
	},
/turf/open/floor/clockwork/reebe,
/area/reebe/city_of_cogs)
"h" = (
/obj/effect/landmark/city_of_cogs,
/turf/open/floor/clockwork/reebe,
/area/reebe/city_of_cogs)
"i" = (
/obj/machinery/sleeper/clockwork{
	dir = 4
	},
/turf/open/floor/clockwork/reebe,
/area/reebe/city_of_cogs)
"j" = (
/obj/machinery/door/airlock/clockwork/glass{
	name = "Listening Station"
	},
/turf/open/floor/clockwork/reebe,
/area/reebe/city_of_cogs)
"k" = (
/obj/structure/window/reinforced/clockwork/fulltile,
/obj/structure/grille/ratvar,
/turf/open/floor/clockwork/reebe,
/area/reebe/city_of_cogs)
"l" = (
/obj/structure/mirror/magic/lesser{
	pixel_x = 32
	},
/turf/open/floor/clockwork/reebe,
/area/reebe/city_of_cogs)
"n" = (
/obj/structure/table/brass,
/obj/item/clockwork/clockwork_slab,
/turf/open/floor/clockwork/reebe,
/area/reebe/city_of_cogs)
"o" = (
/obj/structure/grille/ratvar,
/obj/structure/window/reinforced/clockwork/fulltile,
/turf/open/floor/clockwork/reebe,
/area/reebe/city_of_cogs)
"q" = (
/turf/closed/wall/clockwork,
/area/reebe/city_of_cogs)
"r" = (
/obj/machinery/door/airlock/clockwork/glass{
	name = "Summoning Chamber"
	},
/turf/open/floor/clockwork/reebe,
/area/reebe/city_of_cogs)
"t" = (
/obj/structure/chair/brass,
/turf/open/floor/clockwork/reebe,
/area/reebe/city_of_cogs)
"v" = (
/obj/structure/table/brass,
/obj/effect/mob_spawn/drone/cogscarab,
/turf/open/floor/clockwork/reebe,
/area/reebe/city_of_cogs)
"w" = (
/obj/effect/landmark/servant_of_ratvar,
/turf/open/floor/clockwork/reebe,
/area/reebe/city_of_cogs)
"x" = (
/obj/structure/dresser,
/turf/open/floor/clockwork/reebe,
/area/reebe/city_of_cogs)
"z" = (
/obj/structure/destructible/clockwork/eminence_beacon,
/turf/open/floor/clockwork/reebe,
/area/reebe/city_of_cogs)
"A" = (
/obj/machinery/door/airlock/clockwork/glass{
	name = "Observation Room"
	},
/turf/open/floor/clockwork/reebe,
/area/reebe/city_of_cogs)
"B" = (
/obj/structure/chair/brass{
	dir = 8
	},
/turf/open/floor/clockwork/reebe,
/area/reebe/city_of_cogs)
"C" = (
/obj/effect/clockwork/servant_blocker,
/turf/closed/wall/clockwork,
/area/reebe/city_of_cogs)
"D" = (
/obj/structure/lattice/catwalk/clockwork,
/obj/effect/clockwork/servant_blocker,
/turf/open/indestructible/reebe_void,
/area/reebe/city_of_cogs)
"E" = (
/obj/structure/table/brass,
/obj/item/clockwork/clockwork_slab,
/obj/item/clockwork/clockwork_slab,
/turf/open/floor/clockwork/reebe,
/area/reebe/city_of_cogs)
"H" = (
/turf/open/indestructible/reebe_void/spawning/lattices,
/area/reebe)
"I" = (
/obj/machinery/door/airlock/clockwork/glass,
/turf/open/floor/clockwork/reebe,
/area/reebe/city_of_cogs)
"K" = (
/obj/machinery/door/airlock/clockwork/glass{
	name = "Ark Chamber"
	},
/turf/open/floor/clockwork/reebe,
/area/reebe/city_of_cogs)
"L" = (
/obj/structure/chair/brass{
	dir = 4
	},
/turf/open/floor/clockwork/reebe,
/area/reebe/city_of_cogs)
"N" = (
/obj/structure/table/brass,
/obj/item/toy/plush/plushvar,
/turf/open/floor/clockwork/reebe,
/area/reebe/city_of_cogs)
"O" = (
/obj/structure/table/brass,
/obj/item/clockwork/clockwork_slab,
/obj/item/clockwork/clockwork_slab,
/obj/item/clockwork/clockwork_slab,
/turf/open/floor/clockwork/reebe,
/area/reebe/city_of_cogs)
"P" = (
/turf/open/space/basic,
/area/space)
"R" = (
/turf/open/floor/clockwork/reebe,
/area/reebe/city_of_cogs)
"T" = (
/obj/machinery/telecomms/relay/preset/reebe,
/turf/open/floor/clockwork/reebe,
/area/reebe/city_of_cogs)
"U" = (
/obj/structure/table/brass,
/obj/item/clockwork/replica_fabricator,
/turf/open/floor/clockwork/reebe,
/area/reebe/city_of_cogs)
"V" = (
/obj/machinery/computer/camera_advanced/ratvar,
/turf/open/floor/clockwork/reebe,
/area/reebe/city_of_cogs)
"W" = (
/obj/machinery/computer/camera_advanced/ratvar{
	dir = 8
	},
/turf/open/floor/clockwork/reebe,
/area/reebe/city_of_cogs)
"X" = (
/obj/structure/destructible/clockwork/massive/celestial_gateway,
/turf/open/floor/clockwork/reebe,
/area/reebe/city_of_cogs)
"Y" = (
/obj/structure/table/brass,
/obj/item/storage/firstaid/regular,
/turf/open/floor/clockwork/reebe,
/area/reebe/city_of_cogs)
"Z" = (
/obj/structure/table/brass,
/obj/item/radio/intercom,
/turf/open/floor/clockwork/reebe,
/area/reebe/city_of_cogs)

(1,1,1) = {"
P
P
P
P
P
P
P
P
P
P
P
P
P
P
P
P
P
b
b
b
b
b
b
b
b
b
b
b
b
b
b
b
b
b
b
b
b
b
b
b
b
b
P
P
P
P
P
P
P
P
P
P
P
P
P
P
P
P
P
P
P
P
P
P
P
P
P
P
P
P
P
P
P
P
P
P
"}
(2,1,1) = {"
P
P
P
P
P
P
P
P
P
P
P
P
P
P
P
P
P
b
b
b
b
b
b
b
b
b
b
b
b
b
b
b
b
b
b
b
b
b
b
b
b
b
P
P
P
P
P
P
P
P
P
P
P
P
P
P
P
P
P
P
P
P
P
P
P
P
P
P
P
P
P
P
P
P
P
P
"}
(3,1,1) = {"
P
P
P
P
P
P
P
P
P
P
P
P
P
P
P
P
P
b
b
b
b
b
b
b
b
b
b
b
b
b
b
b
b
b
b
b
b
b
b
b
b
b
P
P
P
P
P
P
P
P
P
P
P
P
P
P
P
P
P
P
P
P
P
P
P
P
P
P
P
P
P
P
P
P
P
P
"}
(4,1,1) = {"
P
P
P
P
P
P
P
P
P
P
P
P
P
P
P
P
P
b
b
b
b
b
b
b
b
b
b
b
b
b
b
b
b
b
b
b
b
b
b
b
b
b
P
P
P
P
P
P
P
P
P
P
P
P
P
P
P
P
P
P
P
P
P
P
P
P
P
P
P
P
P
P
P
P
P
P
"}
(5,1,1) = {"
P
P
P
P
P
P
P
P
P
P
P
P
P
P
P
P
P
b
b
b
b
b
b
b
b
b
b
b
b
b
b
b
b
b
b
b
b
b
b
b
b
b
P
P
P
P
P
P
P
P
P
P
P
P
P
P
P
P
P
P
P
P
P
P
P
P
P
P
P
P
P
P
P
P
P
P
"}
(6,1,1) = {"
P
P
P
P
P
P
P
P
P
P
P
P
P
P
P
P
P
b
b
b
b
b
b
b
b
b
b
b
b
b
b
b
b
b
b
b
b
b
b
b
b
b
P
P
P
P
P
P
P
P
P
P
P
P
P
P
P
P
P
P
P
P
P
P
P
P
P
P
P
P
P
P
P
P
P
P
"}
(7,1,1) = {"
P
P
P
P
P
P
P
P
P
P
P
P
P
P
P
P
P
b
b
b
b
b
b
b
b
b
b
b
b
b
b
b
b
b
b
b
b
b
b
b
b
b
P
P
P
P
P
P
P
P
P
P
P
P
P
P
P
P
P
P
P
P
P
P
P
P
P
P
P
P
P
P
P
P
P
P
"}
(8,1,1) = {"
P
P
P
P
P
P
P
P
P
P
P
P
P
P
P
P
P
b
b
b
b
b
b
b
b
b
b
b
H
H
H
H
H
b
b
b
b
b
b
b
b
b
b
P
P
P
P
P
P
P
P
P
P
P
P
P
P
P
P
P
P
P
P
P
P
P
P
P
P
P
P
P
P
P
P
P
"}
(9,1,1) = {"
P
P
P
P
P
P
P
P
P
P
P
P
P
P
P
P
P
b
b
b
b
b
b
b
b
b
b
H
H
H
H
H
H
H
b
b
b
b
b
b
b
b
b
b
P
P
P
P
P
P
P
P
P
P
P
P
P
P
P
P
P
P
P
P
P
P
P
P
P
P
P
P
P
P
P
P
"}
(10,1,1) = {"
P
P
P
P
P
P
P
P
P
P
P
P
P
P
P
P
P
b
b
b
b
b
b
b
b
b
H
H
H
H
H
H
H
H
H
b
b
b
b
b
b
b
b
b
b
P
P
P
P
P
P
P
P
P
P
P
P
P
P
P
P
P
P
P
P
P
P
P
P
P
P
P
P
P
P
P
"}
(11,1,1) = {"
P
P
P
P
P
P
P
P
P
P
P
P
P
P
P
P
P
b
b
b
b
b
b
b
b
H
H
H
H
H
H
H
H
H
H
H
b
b
b
b
b
b
b
b
b
b
P
P
P
P
P
P
P
P
P
P
P
P
P
P
P
P
P
P
P
P
P
P
P
P
P
P
P
P
P
P
"}
(12,1,1) = {"
P
P
P
P
P
P
P
P
P
P
P
P
P
P
P
P
P
b
b
b
b
b
b
b
H
H
H
H
o
o
o
o
o
H
H
H
H
b
b
b
b
b
b
b
b
b
b
P
P
P
P
P
P
P
P
P
P
P
P
P
P
P
P
P
P
P
P
P
P
P
P
P
P
P
P
P
"}
(13,1,1) = {"
P
P
P
P
P
P
P
P
P
P
P
P
P
P
P
P
P
b
b
b
b
b
b
H
H
H
H
o
o
h
R
h
o
o
H
H
H
H
b
b
b
b
b
b
b
b
b
b
P
P
P
P
P
P
P
P
P
P
P
P
P
P
P
P
P
P
P
P
P
P
P
P
P
P
P
P
"}
(14,1,1) = {"
P
P
P
P
P
P
P
P
P
P
P
P
P
P
P
P
P
b
b
b
b
b
H
H
H
H
o
o
R
R
R
R
R
o
o
H
H
H
H
b
b
b
b
b
b
b
b
b
b
P
P
P
P
P
P
P
P
P
P
P
P
P
P
P
P
P
P
P
P
P
P
P
P
P
P
P
"}
(15,1,1) = {"
P
P
P
P
P
P
P
P
P
P
P
P
P
P
P
P
P
b
b
b
b
b
H
H
H
H
o
h
R
R
R
R
R
h
o
H
H
H
H
b
b
b
b
b
b
b
b
b
b
b
P
P
P
P
P
P
P
P
P
P
P
P
P
P
P
P
P
P
P
P
P
P
P
P
P
P
"}
(16,1,1) = {"
P
P
P
P
P
P
P
P
P
P
P
P
P
P
P
P
P
b
b
b
b
b
H
H
H
H
o
R
R
R
R
R
R
R
o
H
H
H
H
b
b
b
b
b
b
b
b
b
b
b
b
P
P
P
P
P
P
P
P
P
P
P
P
P
P
P
P
P
P
P
P
P
P
P
P
P
"}
(17,1,1) = {"
P
P
P
P
P
P
P
P
P
P
P
P
P
P
P
P
P
b
b
b
b
b
H
H
H
H
o
h
R
R
R
R
R
h
o
H
H
H
H
b
b
b
b
b
b
b
b
b
b
b
b
b
P
P
P
P
P
P
P
P
P
P
P
P
P
P
P
P
P
P
P
P
P
P
P
P
"}
(18,1,1) = {"
P
P
P
P
P
P
P
P
P
P
P
P
P
P
P
P
P
b
b
b
b
b
H
H
H
H
o
o
R
R
R
R
R
o
o
H
H
H
H
b
b
b
b
b
b
b
b
b
b
b
b
b
b
P
P
P
P
P
P
P
P
P
P
P
P
P
P
P
P
P
P
P
P
P
P
P
"}
(19,1,1) = {"
P
P
P
P
P
P
P
P
P
P
P
P
P
P
P
P
P
b
b
b
b
b
b
H
H
H
H
o
o
R
R
R
o
o
H
H
H
H
b
b
b
b
b
b
b
b
b
b
b
b
b
b
b
b
P
P
P
P
P
P
P
P
P
P
P
P
P
P
P
P
P
P
P
P
P
P
"}
(20,1,1) = {"
P
P
P
P
P
P
P
P
P
P
P
P
P
P
P
P
P
b
b
b
b
b
b
b
H
H
H
H
o
k
I
k
o
H
H
H
H
b
b
b
b
b
b
b
b
b
b
b
b
b
b
b
b
b
b
P
P
P
P
P
P
P
P
P
P
P
P
P
P
P
P
P
P
P
P
P
"}
(21,1,1) = {"
P
P
P
P
P
P
P
P
P
P
P
P
P
P
P
P
P
b
b
b
b
b
b
b
H
H
H
H
o
R
R
R
o
H
H
H
H
H
b
b
b
b
b
b
b
b
b
b
b
b
b
b
b
b
b
b
P
P
P
P
P
P
P
P
P
P
P
P
P
P
P
P
P
P
P
P
"}
(22,1,1) = {"
P
P
P
P
P
P
P
P
P
P
P
P
P
P
P
P
P
b
b
b
b
b
b
b
H
H
H
H
o
R
R
R
o
H
H
H
H
H
H
H
H
b
b
b
b
b
b
b
b
b
b
b
b
b
b
b
b
P
P
P
P
P
P
P
P
P
P
P
P
P
P
P
P
P
P
P
"}
(23,1,1) = {"
P
P
P
P
P
P
P
P
P
P
P
P
P
P
P
P
P
b
b
b
b
b
b
b
H
H
H
H
o
R
R
R
o
H
H
H
H
H
H
H
H
H
H
H
b
b
b
b
b
b
b
b
b
b
b
b
b
b
P
P
P
P
P
P
P
P
P
P
P
P
P
P
P
P
P
P
"}
(24,1,1) = {"
P
P
P
P
P
P
P
P
P
P
P
P
P
P
P
P
P
b
b
b
b
b
b
b
H
H
H
H
o
R
R
R
o
H
H
H
H
H
H
H
H
H
H
H
H
H
b
b
b
b
b
b
b
b
b
b
b
b
b
P
P
P
P
P
P
P
P
P
P
P
P
P
P
P
P
P
"}
(25,1,1) = {"
P
P
P
P
P
P
P
P
P
P
P
P
P
P
P
P
b
b
b
b
b
b
b
H
H
H
H
o
o
R
R
R
o
o
o
o
o
o
H
H
H
H
H
H
H
H
H
H
b
b
b
b
b
b
b
b
b
b
b
b
P
P
P
P
P
P
P
P
P
P
P
P
P
P
P
P
"}
(26,1,1) = {"
P
P
P
P
P
P
P
P
P
P
P
P
P
P
P
b
b
b
b
b
b
b
b
H
H
H
H
o
R
R
R
R
R
R
R
R
R
o
o
o
o
H
H
H
H
H
H
H
H
b
b
b
b
b
b
b
b
b
b
b
b
P
P
P
P
P
P
P
P
P
P
P
P
P
P
P
"}
(27,1,1) = {"
P
P
P
P
P
P
P
P
P
P
P
P
P
P
b
b
b
b
b
b
b
b
b
H
H
H
H
o
R
R
R
R
R
R
R
R
R
R
R
R
o
o
o
o
H
H
H
H
H
H
b
b
b
b
b
b
b
b
b
b
b
b
P
P
P
P
P
P
P
P
P
P
P
P
P
P
"}
(28,1,1) = {"
P
P
P
P
P
P
P
P
P
P
P
P
P
b
b
b
b
b
b
b
b
b
b
H
H
H
H
q
q
q
I
q
q
q
q
R
R
R
R
R
R
R
R
o
o
o
H
H
H
H
H
b
b
b
b
b
b
b
b
b
b
b
b
P
P
P
P
P
P
P
P
P
P
P
P
P
"}
(29,1,1) = {"
P
P
P
P
P
P
P
P
P
P
P
P
b
b
b
b
b
b
b
b
b
b
b
H
H
H
H
q
R
R
R
R
R
R
q
q
q
q
R
R
R
R
R
R
R
o
o
o
H
H
H
H
b
b
b
b
b
b
b
b
b
b
b
b
P
P
P
P
P
P
P
P
P
P
P
P
"}
(30,1,1) = {"
P
P
P
P
P
P
P
P
P
P
P
b
b
b
b
b
b
b
b
b
b
b
b
H
H
H
H
q
R
R
R
R
R
R
R
R
R
q
q
q
q
R
R
R
R
R
R
o
o
H
H
H
H
b
b
b
b
b
b
b
b
b
b
b
b
P
P
P
P
P
P
P
P
P
P
P
"}
(31,1,1) = {"
P
P
P
P
P
P
P
P
P
P
b
b
b
b
b
b
b
b
b
b
b
b
b
H
H
H
H
q
R
R
R
R
R
R
R
R
R
R
R
R
q
q
q
q
R
R
R
R
o
o
H
H
H
H
b
b
b
b
b
b
b
b
b
b
b
b
P
P
P
P
P
P
P
P
P
P
"}
(32,1,1) = {"
P
P
P
P
P
P
P
P
P
b
b
b
b
b
b
b
b
b
b
b
b
b
b
b
b
b
b
C
D
D
D
D
D
D
R
R
R
R
R
R
R
R
R
q
q
R
R
R
R
o
o
H
H
H
H
b
b
b
b
b
b
b
b
b
b
b
b
P
P
P
P
P
P
P
P
P
"}
(33,1,1) = {"
P
P
P
P
P
P
P
P
b
b
b
b
b
b
b
b
b
b
b
b
b
b
b
H
H
H
H
q
R
R
R
R
R
D
D
D
D
R
R
R
R
R
R
R
q
q
R
R
R
R
o
H
H
H
H
b
b
b
b
b
b
b
b
b
b
b
b
b
P
P
P
P
P
P
P
P
"}
(34,1,1) = {"
P
P
P
P
P
P
P
b
b
b
b
b
b
b
b
b
b
b
b
b
b
b
b
H
H
H
H
o
R
R
R
R
R
R
R
R
D
D
D
D
R
R
R
R
R
q
q
R
R
R
o
o
H
H
H
H
b
b
b
b
b
b
b
b
b
b
b
b
b
P
P
P
P
P
P
P
"}
(35,1,1) = {"
P
P
P
P
P
P
b
b
b
b
b
b
b
b
b
b
b
b
b
b
b
b
H
H
H
H
H
o
R
R
R
R
R
R
R
R
R
R
R
D
D
D
R
R
R
R
q
q
R
R
R
o
H
H
H
H
b
b
b
b
b
b
b
b
b
b
b
b
b
b
P
P
P
P
P
P
"}
(36,1,1) = {"
P
P
P
P
P
b
b
b
b
b
b
b
b
b
b
b
b
b
b
b
b
H
H
H
H
H
H
o
R
R
R
R
R
R
R
R
R
R
R
R
R
D
D
R
R
R
R
q
q
R
R
o
o
H
H
H
H
b
b
b
b
b
b
b
b
b
b
b
b
b
b
P
P
P
P
P
"}
(37,1,1) = {"
b
b
b
b
b
b
b
b
b
b
b
b
b
b
b
b
H
H
H
H
H
H
H
H
H
H
H
o
R
R
R
R
R
R
R
R
R
R
R
R
R
R
D
D
R
R
R
R
q
R
R
R
o
H
H
H
H
b
b
b
b
b
b
b
b
b
b
b
b
b
b
b
P
P
P
P
"}
(38,1,1) = {"
b
b
b
b
b
b
b
b
b
b
b
b
b
b
b
H
H
H
H
H
H
H
H
H
H
H
H
o
R
R
R
R
R
R
R
R
R
R
R
R
R
R
R
D
D
R
R
R
q
R
R
R
o
H
H
H
H
b
b
b
b
b
b
b
b
b
b
b
b
b
b
b
b
P
P
P
"}
(39,1,1) = {"
b
b
b
b
b
b
b
b
b
b
b
b
b
b
H
H
H
H
H
H
H
H
H
H
H
H
H
o
R
R
R
R
R
R
R
R
R
R
R
R
R
R
R
R
D
R
R
R
q
q
R
R
o
o
H
H
H
H
b
b
b
b
b
b
b
b
b
b
b
b
b
b
b
b
P
P
"}
(40,1,1) = {"
b
b
b
b
b
b
b
b
b
b
b
b
b
H
H
H
H
H
H
H
H
H
H
H
H
H
H
q
R
R
R
R
R
R
R
R
R
R
R
R
R
R
R
R
D
D
R
R
R
q
R
R
R
o
H
H
H
H
b
b
b
b
b
b
b
b
b
b
b
b
b
b
b
b
b
P
"}
(41,1,1) = {"
b
b
b
b
b
b
b
b
b
b
b
b
H
H
H
H
q
o
o
q
q
q
q
o
o
q
q
q
R
R
R
R
R
R
R
R
R
R
R
R
R
R
R
R
R
D
R
R
R
q
R
R
R
o
H
H
H
H
b
b
b
b
b
b
b
b
b
b
b
b
b
b
b
b
b
b
"}
(42,1,1) = {"
b
b
b
b
b
b
b
b
b
b
b
H
H
H
H
q
q
a
R
e
Y
q
Z
R
R
Z
q
q
R
R
R
R
R
R
R
R
R
R
R
R
R
R
R
R
R
D
R
R
R
q
q
R
R
o
o
H
H
H
H
b
b
b
b
b
b
b
b
b
b
b
b
b
b
b
b
b
"}
(43,1,1) = {"
b
b
b
b
b
b
b
b
b
b
H
H
H
H
q
q
e
a
R
R
R
o
B
R
R
B
Z
q
q
R
R
R
R
R
R
R
R
R
R
R
R
R
R
R
R
D
D
R
R
R
q
R
R
R
o
H
H
H
H
b
b
H
H
H
H
H
b
b
b
b
b
b
b
b
b
b
"}
(44,1,1) = {"
b
b
b
b
H
H
H
H
H
H
H
H
H
H
o
i
i
R
R
R
R
c
R
R
R
R
t
Z
q
R
R
R
R
R
R
R
R
R
R
R
R
R
R
R
R
R
D
R
R
R
q
R
R
R
o
H
H
H
H
b
H
H
H
H
H
H
H
b
b
b
b
b
b
b
b
b
"}
(45,1,1) = {"
b
b
b
b
H
H
H
H
H
H
H
H
H
H
o
R
R
R
R
R
R
o
L
R
L
R
R
R
q
R
R
R
R
R
R
R
R
R
R
R
R
R
R
R
R
R
D
R
R
R
q
q
R
R
o
H
H
H
H
H
H
H
H
H
H
H
H
H
b
b
b
b
b
b
b
b
"}
(46,1,1) = {"
b
b
b
b
H
H
H
H
H
H
H
H
H
H
q
l
R
R
R
x
Y
q
Z
T
Z
R
R
R
q
R
R
R
R
R
R
R
R
R
R
R
R
R
R
R
R
R
D
D
R
R
R
q
R
R
o
H
H
H
H
H
H
H
H
H
H
H
H
H
H
b
b
b
b
b
b
b
"}
(47,1,1) = {"
b
b
b
b
H
H
H
H
H
H
H
H
H
H
q
q
o
c
o
q
q
q
q
q
q
o
j
o
q
R
R
R
R
R
R
R
R
R
R
R
R
R
R
R
R
R
R
D
R
R
R
q
R
R
o
H
H
H
H
H
H
o
o
o
o
o
H
H
H
H
b
b
b
b
b
b
"}
(48,1,1) = {"
b
b
b
b
H
H
H
H
q
q
o
o
o
q
q
R
R
R
R
R
R
R
R
R
q
v
R
R
R
R
R
R
R
R
R
R
R
R
R
R
R
R
R
R
R
R
R
D
R
R
R
q
R
R
o
H
H
H
H
H
o
o
h
R
h
o
o
H
H
H
H
b
b
b
b
b
"}
(49,1,1) = {"
b
b
b
b
H
H
H
H
q
w
w
R
w
w
q
R
R
R
d
R
d
R
d
R
o
E
R
R
R
R
R
R
R
R
R
R
R
R
R
R
R
R
R
R
R
R
R
D
R
R
R
q
R
R
o
o
o
o
o
o
o
R
R
R
R
R
o
o
H
H
H
H
b
b
b
b
"}
(50,1,1) = {"
b
b
b
b
H
H
H
H
o
w
R
R
R
w
o
R
n
R
d
R
d
R
d
R
o
R
R
R
R
R
R
R
R
R
R
R
R
R
R
R
R
R
R
R
R
R
R
D
R
R
R
q
R
R
R
R
R
R
R
o
R
R
R
R
R
R
h
o
H
H
H
H
b
b
b
b
"}
(51,1,1) = {"
b
b
b
b
H
H
H
H
o
R
R
X
R
R
r
R
N
R
R
R
R
R
R
R
K
R
R
R
R
R
R
R
R
R
R
R
R
R
R
R
R
R
R
R
R
R
R
D
R
R
R
I
R
R
R
R
R
R
R
I
R
R
R
R
R
R
R
o
H
H
H
H
b
b
b
b
"}
(52,1,1) = {"
b
b
b
b
H
H
H
H
o
w
R
R
R
w
o
R
z
R
d
R
d
R
d
R
o
R
R
R
R
R
R
R
R
R
R
R
R
R
R
R
R
R
R
R
R
R
R
D
R
R
R
q
R
R
R
R
R
R
R
o
R
R
R
R
R
R
h
o
H
H
H
H
b
b
b
b
"}
(53,1,1) = {"
b
b
b
b
H
H
H
H
q
w
w
R
w
w
q
R
R
R
d
R
d
R
d
R
o
E
R
R
R
R
R
R
R
R
R
R
R
R
R
R
R
R
R
R
R
R
R
D
R
R
R
q
R
R
o
o
o
o
o
o
o
R
R
R
R
R
o
o
H
H
H
H
b
b
b
b
"}
(54,1,1) = {"
b
b
b
b
H
H
H
H
q
q
o
o
o
q
q
R
R
R
R
R
R
R
R
R
q
v
R
R
R
R
R
R
R
R
R
R
R
R
R
R
R
R
R
R
R
R
R
D
R
R
R
q
R
R
o
H
H
H
H
H
o
o
h
R
h
o
o
H
H
H
H
b
b
b
b
b
"}
(55,1,1) = {"
b
b
b
b
H
H
H
H
H
H
H
H
H
H
q
q
o
A
o
q
q
q
q
q
q
o
K
o
q
R
R
R
R
R
R
R
R
R
R
R
R
R
R
R
R
R
R
D
R
R
R
q
R
R
o
H
H
H
H
H
H
o
o
o
o
o
H
H
H
H
b
b
b
b
b
b
"}
(56,1,1) = {"
b
b
b
b
H
H
H
H
H
H
H
H
H
H
q
V
d
R
R
g
e
q
O
e
O
R
R
R
q
R
R
R
R
R
R
R
R
R
R
R
R
R
R
R
R
R
D
D
R
R
R
q
R
R
o
H
H
H
H
H
H
H
H
H
H
H
H
H
H
b
b
b
b
b
b
b
"}
(57,1,1) = {"
b
b
b
b
H
H
H
H
H
H
H
H
H
H
o
e
R
R
R
B
R
o
R
R
R
R
R
R
q
R
R
R
R
R
R
R
R
R
R
R
R
R
R
R
R
R
D
R
R
R
q
q
R
R
o
H
H
H
H
H
H
H
H
H
H
H
H
H
b
b
b
b
b
b
b
b
"}
(58,1,1) = {"
b
b
b
b
H
H
H
H
H
H
H
H
H
H
o
V
d
R
R
R
R
A
R
R
R
R
R
U
q
R
R
R
R
R
R
R
R
R
R
R
R
R
R
R
R
R
D
R
R
R
q
R
R
R
o
H
H
H
H
b
H
H
H
H
H
H
H
b
b
b
b
b
b
b
b
b
"}
(59,1,1) = {"
b
b
b
b
b
b
b
b
b
b
H
H
H
H
q
q
e
L
R
L
R
o
R
R
R
R
e
q
q
R
R
R
R
R
R
R
R
R
R
R
R
R
R
R
R
D
D
R
R
R
q
R
R
R
o
H
H
H
H
b
b
H
H
H
H
H
b
b
b
b
b
b
b
b
b
b
"}
(60,1,1) = {"
b
b
b
b
b
b
b
b
b
b
b
H
H
H
H
q
q
W
e
W
e
q
e
R
R
U
q
q
R
R
R
R
R
R
R
R
R
R
R
R
R
R
R
R
R
D
R
R
R
q
q
R
R
o
o
H
H
H
H
b
b
b
b
b
b
b
b
b
b
b
b
b
b
b
b
b
"}
(61,1,1) = {"
b
b
b
b
b
b
b
b
b
b
b
b
H
H
H
H
q
o
o
q
q
q
q
o
o
q
q
q
R
R
R
R
R
R
R
R
R
R
R
R
R
R
R
R
R
D
R
R
R
q
R
R
R
o
H
H
H
H
b
b
b
b
b
b
b
b
b
b
b
b
b
b
b
b
b
b
"}
(62,1,1) = {"
b
b
b
b
b
b
b
b
b
b
b
b
b
H
H
H
H
H
H
H
H
H
H
H
H
H
H
q
R
R
R
R
R
R
R
R
R
R
R
R
R
R
R
R
D
D
R
R
R
q
R
R
R
o
H
H
H
H
b
b
b
b
b
b
b
b
b
b
b
b
b
b
b
b
b
P
"}
(63,1,1) = {"
b
b
b
b
b
b
b
b
b
b
b
b
b
b
H
H
H
H
H
H
H
H
H
H
H
H
H
o
R
R
R
R
R
R
R
R
R
R
R
R
R
R
R
R
D
R
R
R
q
q
R
R
o
o
H
H
H
H
b
b
b
b
b
b
b
b
b
b
b
b
b
b
b
b
P
P
"}
(64,1,1) = {"
b
b
b
b
b
b
b
b
b
b
b
b
b
b
b
H
H
H
H
H
H
H
H
H
H
H
H
o
R
R
R
R
R
R
R
R
R
R
R
R
R
R
R
D
D
R
R
R
q
R
R
R
o
H
H
H
H
b
b
b
b
b
b
b
b
b
b
b
b
b
b
b
b
P
P
P
"}
(65,1,1) = {"
b
b
b
b
b
b
b
b
b
b
b
b
b
b
b
b
H
H
H
H
H
H
H
H
H
H
H
o
R
R
R
R
R
R
R
R
R
R
R
R
R
R
D
D
R
R
R
R
q
R
R
R
o
H
H
H
H
b
b
b
b
b
b
b
b
b
b
b
b
b
b
b
P
P
P
P
"}
(66,1,1) = {"
P
P
P
P
P
b
b
b
b
b
b
b
b
b
b
b
b
b
b
b
b
H
H
H
H
H
H
o
R
R
R
R
R
R
R
R
R
R
R
R
R
D
D
R
R
R
R
q
q
R
R
o
o
H
H
H
H
b
b
b
b
b
b
b
b
b
b
b
b
b
b
P
P
P
P
P
"}
(67,1,1) = {"
P
P
P
P
P
P
b
b
b
b
b
b
b
b
b
b
b
b
b
b
b
b
H
H
H
H
H
o
R
R
R
R
R
R
R
R
R
R
R
D
D
D
R
R
R
R
q
q
R
R
R
o
H
H
H
H
b
b
b
b
b
b
b
b
b
b
b
b
b
b
P
P
P
P
P
P
"}
(68,1,1) = {"
P
P
P
P
P
P
P
b
b
b
b
b
b
b
b
b
b
b
b
b
b
b
b
H
H
H
H
o
R
R
R
R
R
R
R
R
D
D
D
D
R
R
R
R
R
q
q
R
R
R
o
o
H
H
H
H
b
b
b
b
b
b
b
b
b
b
b
b
b
P
P
P
P
P
P
P
"}
(69,1,1) = {"
P
P
P
P
P
P
P
P
b
b
b
b
b
b
b
b
b
b
b
b
b
b
b
H
H
H
H
q
R
R
R
R
R
D
D
D
D
R
R
R
R
R
R
R
q
q
R
R
R
R
o
H
H
H
H
b
b
b
b
b
b
b
b
b
b
b
b
b
P
P
P
P
P
P
P
P
"}
(70,1,1) = {"
P
P
P
P
P
P
P
P
P
b
b
b
b
b
b
b
b
b
b
b
b
b
b
b
b
b
b
C
D
D
D
D
D
D
R
R
R
R
R
R
R
R
R
q
q
R
R
R
R
o
o
H
H
H
H
b
b
b
b
b
b
b
b
b
b
b
b
P
P
P
P
P
P
P
P
P
"}
(71,1,1) = {"
P
P
P
P
P
P
P
P
P
P
b
b
b
b
b
b
b
b
b
b
b
b
b
H
H
H
H
q
R
R
R
R
R
R
R
R
R
R
R
R
q
q
q
q
R
R
R
R
o
o
H
H
H
H
b
b
b
b
b
b
b
b
b
b
b
b
P
P
P
P
P
P
P
P
P
P
"}
(72,1,1) = {"
P
P
P
P
P
P
P
P
P
P
P
b
b
b
b
b
b
b
b
b
b
b
b
H
H
H
H
q
R
R
R
R
R
R
R
R
R
q
q
q
q
R
R
R
R
R
R
o
o
H
H
H
H
b
b
b
b
b
b
b
b
b
b
b
b
P
P
P
P
P
P
P
P
P
P
P
"}
(73,1,1) = {"
P
P
P
P
P
P
P
P
P
P
P
P
b
b
b
b
b
b
b
b
b
b
b
H
H
H
H
q
R
R
R
R
R
R
q
q
q
q
R
R
R
R
R
R
R
o
o
o
H
H
H
H
b
b
b
b
b
b
b
b
b
b
b
b
P
P
P
P
P
P
P
P
P
P
P
P
"}
(74,1,1) = {"
P
P
P
P
P
P
P
P
P
P
P
P
P
b
b
b
b
b
b
b
b
b
b
H
H
H
H
q
q
q
I
q
q
q
q
R
R
R
R
R
R
R
R
o
o
o
H
H
H
H
H
b
b
b
b
b
b
b
b
b
b
b
b
P
P
P
P
P
P
P
P
P
P
P
P
P
"}
(75,1,1) = {"
P
P
P
P
P
P
P
P
P
P
P
P
P
P
b
b
b
b
b
b
b
b
b
H
H
H
H
o
R
R
R
R
R
R
R
R
R
R
R
R
o
o
o
o
H
H
H
H
H
H
b
b
b
b
b
b
b
b
b
b
b
b
P
P
P
P
P
P
P
P
P
P
P
P
P
P
"}
(76,1,1) = {"
P
P
P
P
P
P
P
P
P
P
P
P
P
P
P
b
b
b
b
b
b
b
b
H
H
H
H
o
R
R
R
R
R
R
R
R
R
o
o
o
o
H
H
H
H
H
H
H
H
b
b
b
b
b
b
b
b
b
b
b
b
P
P
P
P
P
P
P
P
P
P
P
P
P
P
P
"}
(77,1,1) = {"
P
P
P
P
P
P
P
P
P
P
P
P
P
P
P
P
b
b
b
b
b
b
b
H
H
H
H
o
o
R
R
R
o
o
o
o
o
o
H
H
H
H
H
H
H
H
H
H
b
b
b
b
b
b
b
b
b
b
b
b
P
P
P
P
P
P
P
P
P
P
P
P
P
P
P
P
"}
(78,1,1) = {"
P
P
P
P
P
P
P
P
P
P
P
P
P
P
P
P
P
b
b
b
b
b
b
b
H
H
H
H
o
R
R
R
o
H
H
H
H
H
H
H
H
H
H
H
H
H
b
b
b
b
b
b
b
b
b
b
b
b
b
P
P
P
P
P
P
P
P
P
P
P
P
P
P
P
P
P
"}
(79,1,1) = {"
P
P
P
P
P
P
P
P
P
P
P
P
P
P
P
P
P
b
b
b
b
b
b
b
H
H
H
H
o
R
R
R
o
H
H
H
H
H
H
H
H
H
H
H
b
b
b
b
b
b
b
b
b
b
b
b
b
b
P
P
P
P
P
P
P
P
P
P
P
P
P
P
P
P
P
P
"}
(80,1,1) = {"
P
P
P
P
P
P
P
P
P
P
P
P
P
P
P
P
P
b
b
b
b
b
b
b
H
H
H
H
o
R
R
R
o
H
H
H
H
H
H
H
H
b
b
b
b
b
b
b
b
b
b
b
b
b
b
b
b
P
P
P
P
P
P
P
P
P
P
P
P
P
P
P
P
P
P
P
"}
(81,1,1) = {"
P
P
P
P
P
P
P
P
P
P
P
P
P
P
P
P
P
b
b
b
b
b
b
b
H
H
H
H
o
R
R
R
o
H
H
H
H
H
b
b
b
b
b
b
b
b
b
b
b
b
b
b
b
b
b
b
P
P
P
P
P
P
P
P
P
P
P
P
P
P
P
P
P
P
P
P
"}
(82,1,1) = {"
P
P
P
P
P
P
P
P
P
P
P
P
P
P
P
P
P
b
b
b
b
b
b
b
H
H
H
H
o
k
I
k
o
H
H
H
H
b
b
b
b
b
b
b
b
b
b
b
b
b
b
b
b
b
b
P
P
P
P
P
P
P
P
P
P
P
P
P
P
P
P
P
P
P
P
P
"}
(83,1,1) = {"
P
P
P
P
P
P
P
P
P
P
P
P
P
P
P
P
P
b
b
b
b
b
b
H
H
H
H
o
o
R
R
R
o
o
H
H
H
H
b
b
b
b
b
b
b
b
b
b
b
b
b
b
b
b
P
P
P
P
P
P
P
P
P
P
P
P
P
P
P
P
P
P
P
P
P
P
"}
(84,1,1) = {"
P
P
P
P
P
P
P
P
P
P
P
P
P
P
P
P
P
b
b
b
b
b
H
H
H
H
o
o
R
R
R
R
R
o
o
H
H
H
H
b
b
b
b
b
b
b
b
b
b
b
b
b
b
P
P
P
P
P
P
P
P
P
P
P
P
P
P
P
P
P
P
P
P
P
P
P
"}
(85,1,1) = {"
P
P
P
P
P
P
P
P
P
P
P
P
P
P
P
P
P
b
b
b
b
b
H
H
H
H
o
h
R
R
R
R
R
h
o
H
H
H
H
b
b
b
b
b
b
b
b
b
b
b
b
b
P
P
P
P
P
P
P
P
P
P
P
P
P
P
P
P
P
P
P
P
P
P
P
P
"}
(86,1,1) = {"
P
P
P
P
P
P
P
P
P
P
P
P
P
P
P
P
P
b
b
b
b
b
H
H
H
H
o
R
R
R
R
R
R
R
o
H
H
H
H
b
b
b
b
b
b
b
b
b
b
b
b
P
P
P
P
P
P
P
P
P
P
P
P
P
P
P
P
P
P
P
P
P
P
P
P
P
"}
(87,1,1) = {"
P
P
P
P
P
P
P
P
P
P
P
P
P
P
P
P
P
b
b
b
b
b
H
H
H
H
o
h
R
R
R
R
R
h
o
H
H
H
H
b
b
b
b
b
b
b
b
b
b
b
P
P
P
P
P
P
P
P
P
P
P
P
P
P
P
P
P
P
P
P
P
P
P
P
P
P
"}
(88,1,1) = {"
P
P
P
P
P
P
P
P
P
P
P
P
P
P
P
P
P
b
b
b
b
b
H
H
H
H
o
o
R
R
R
R
R
o
o
H
H
H
H
b
b
b
b
b
b
b
b
b
b
P
P
P
P
P
P
P
P
P
P
P
P
P
P
P
P
P
P
P
P
P
P
P
P
P
P
P
"}
(89,1,1) = {"
P
P
P
P
P
P
P
P
P
P
P
P
P
P
P
P
P
b
b
b
b
b
b
H
H
H
H
o
o
h
R
h
o
o
H
H
H
H
b
b
b
b
b
b
b
b
b
b
P
P
P
P
P
P
P
P
P
P
P
P
P
P
P
P
P
P
P
P
P
P
P
P
P
P
P
P
"}
(90,1,1) = {"
P
P
P
P
P
P
P
P
P
P
P
P
P
P
P
P
P
b
b
b
b
b
b
b
H
H
H
H
o
o
o
o
o
H
H
H
H
b
b
b
b
b
b
b
b
b
b
P
P
P
P
P
P
P
P
P
P
P
P
P
P
P
P
P
P
P
P
P
P
P
P
P
P
P
P
P
"}
(91,1,1) = {"
P
P
P
P
P
P
P
P
P
P
P
P
P
P
P
P
P
b
b
b
b
b
b
b
b
H
H
H
H
H
H
H
H
H
H
H
b
b
b
b
b
b
b
b
b
b
P
P
P
P
P
P
P
P
P
P
P
P
P
P
P
P
P
P
P
P
P
P
P
P
P
P
P
P
P
P
"}
(92,1,1) = {"
P
P
P
P
P
P
P
P
P
P
P
P
P
P
P
P
P
b
b
b
b
b
b
b
b
b
H
H
H
H
H
H
H
H
H
b
b
b
b
b
b
b
b
b
b
P
P
P
P
P
P
P
P
P
P
P
P
P
P
P
P
P
P
P
P
P
P
P
P
P
P
P
P
P
P
P
"}
(93,1,1) = {"
P
P
P
P
P
P
P
P
P
P
P
P
P
P
P
P
P
b
b
b
b
b
b
b
b
b
b
H
H
H
H
H
H
H
b
b
b
b
b
b
b
b
b
b
P
P
P
P
P
P
P
P
P
P
P
P
P
P
P
P
P
P
P
P
P
P
P
P
P
P
P
P
P
P
P
P
"}
(94,1,1) = {"
P
P
P
P
P
P
P
P
P
P
P
P
P
P
P
P
P
b
b
b
b
b
b
b
b
b
b
b
H
H
H
H
H
b
b
b
b
b
b
b
b
b
b
P
P
P
P
P
P
P
P
P
P
P
P
P
P
P
P
P
P
P
P
P
P
P
P
P
P
P
P
P
P
P
P
P
"}
(95,1,1) = {"
P
P
P
P
P
P
P
P
P
P
P
P
P
P
P
P
P
b
b
b
b
b
b
b
b
b
b
b
b
b
b
b
b
b
b
b
b
b
b
b
b
b
P
P
P
P
P
P
P
P
P
P
P
P
P
P
P
P
P
P
P
P
P
P
P
P
P
P
P
P
P
P
P
P
P
P
"}
(96,1,1) = {"
P
P
P
P
P
P
P
P
P
P
P
P
P
P
P
P
P
b
b
b
b
b
b
b
b
b
b
b
b
b
b
b
b
b
b
b
b
b
b
b
b
b
P
P
P
P
P
P
P
P
P
P
P
P
P
P
P
P
P
P
P
P
P
P
P
P
P
P
P
P
P
P
P
P
P
P
"}
(97,1,1) = {"
P
P
P
P
P
P
P
P
P
P
P
P
P
P
P
P
P
b
b
b
b
b
b
b
b
b
b
b
b
b
b
b
b
b
b
b
b
b
b
b
b
b
P
P
P
P
P
P
P
P
P
P
P
P
P
P
P
P
P
P
P
P
P
P
P
P
P
P
P
P
P
P
P
P
P
P
"}
(98,1,1) = {"
P
P
P
P
P
P
P
P
P
P
P
P
P
P
P
P
P
b
b
b
b
b
b
b
b
b
b
b
b
b
b
b
b
b
b
b
b
b
b
b
b
b
P
P
P
P
P
P
P
P
P
P
P
P
P
P
P
P
P
P
P
P
P
P
P
P
P
P
P
P
P
P
P
P
P
P
"}
(99,1,1) = {"
P
P
P
P
P
P
P
P
P
P
P
P
P
P
P
P
P
b
b
b
b
b
b
b
b
b
b
b
b
b
b
b
b
b
b
b
b
b
b
b
b
b
P
P
P
P
P
P
P
P
P
P
P
P
P
P
P
P
P
P
P
P
P
P
P
P
P
P
P
P
P
P
P
P
P
P
"}
